#####
#P F#
#F E#
#F E#
#F E#
#F E#
#F E#
#F E#
#F E#
#####